15 10
#Terrain
1 1 1 1 1 1 1 1 1 1
1 0 0 1 1 1 1 0 0 1
1 0 0 0 0 0 0 0 0 1
1 0 0 1 1 1 1 0 0 1
1 0 0 0 0 0 1 0 0 1
1 0 0 0 0 0 1 0 0 1
1 0 0 0 0 0 1 0 0 1
1 0 0 0 0 0 1 0 0 1
1 0 0 0 0 0 1 0 0 1
1 0 0 0 0 0 1 0 0 1
1 0 0 0 0 0 1 0 0 1
1 0 0 0 0 0 1 0 0 1
1 0 0 0 0 0 0 0 0 1
1 0 0 0 0 0 1 0 2 1
1 1 1 1 1 1 1 1 1 1
#Creature
0 0 0 0 0 0 0 0 0 0
0 h s 0 0 0 0 0 0 0
0 0 s m s s s s s 0
0 0 s 0 0 0 0 s s 0
0 0 0 0 0 0 0 0 0 0
0 0 0 0 0 0 0 0 0 0
0 0 0 0 0 0 0 0 0 0
0 0 0 0 0 0 0 0 0 0
0 0 0 0 0 0 0 0 0 0
0 0 0 0 0 0 0 0 0 0
0 0 0 0 0 0 0 0 0 0
0 0 0 0 0 0 0 0 0 0
0 0 0 m 0 0 0 0 0 0
0 0 0 0 0 0 0 s 0 0
0 0 0 0 0 0 0 0 0 0