15 10
#Terrain
1 1 1 1 1 1 1 1 1 1
1 2 0 0 0 0 0 0 0 1
1 0 0 0 0 0 0 0 0 1
1 0 0 0 0 0 0 0 0 1
1 0 0 0 0 0 0 0 0 1
1 0 0 0 0 0 0 0 0 1
1 0 0 0 0 0 0 0 0 1
1 0 0 0 1 0 0 0 0 1
1 0 0 0 0 0 0 0 0 1
1 0 0 0 0 0 0 0 0 1
1 0 0 0 0 0 0 0 0 1
1 0 0 0 0 0 0 0 0 1
1 0 0 0 0 0 0 0 0 1
1 0 0 0 0 0 0 0 0 1
1 1 1 1 1 1 1 1 1 1
#Creature
0 0 0 0 0 0 0 0 0 0
0 0 0 0 0 0 0 0 0 0
0 0 0 0 0 0 0 s s 0
0 0 0 0 0 0 0 s s 0
0 0 0 0 0 0 0 s s 0
0 0 0 0 0 0 0 0 s 0
0 0 0 0 0 0 0 0 s 0
0 0 0 0 0 0 0 0 s 0
0 0 0 0 0 0 0 0 s 0
0 0 0 0 0 0 0 0 m 0
0 0 0 0 0 0 0 0 m 0
0 0 0 0 0 0 m 0 m 0
0 0 n 0 0 0 m 0 m 0
0 h 0 0 0 0 m s s 0
0 0 0 0 0 0 0 0 0 0