16 16
#Terrain
1 1 1 1 1 1 1 1 1 1 1 1 1 1 1 1
1 0 0 0 0 0 0 0 0 0 0 0 0 0 0 1
1 0 0 0 0 0 0 0 0 0 0 0 0 0 0 1
1 0 0 0 0 0 0 0 0 0 0 0 0 0 0 1
1 0 0 0 0 0 0 0 0 0 0 0 0 0 0 1
1 0 0 0 0 0 0 0 0 0 0 0 0 0 0 1
1 0 0 0 0 0 0 0 0 0 0 0 0 0 0 1
1 0 0 0 0 0 0 0 0 0 0 0 0 0 0 1
1 0 0 0 0 0 0 0 0 0 0 0 0 0 0 1
1 0 0 0 0 0 0 0 0 0 0 0 0 0 0 1
1 0 0 0 0 0 0 0 0 0 0 0 0 0 0 1
1 0 0 0 0 0 0 0 0 0 0 0 0 0 0 1
1 0 0 0 0 0 0 0 0 0 0 0 0 0 0 1
1 0 0 0 0 0 0 0 0 0 0 0 0 1 0 1
1 2 0 0 0 0 0 0 0 0 0 0 0 0 0 1
1 1 1 1 1 1 1 1 1 1 1 1 1 1 1 1
#Creature
0 0 0 0 0 0 0 0 0 0 0 0 0 0 0 0
0 0 b 0 0 0 0 0 0 0 0 b 0 0 0 0
0 0 0 m s 0 0 0 s 0 0 0 0 0 0 0
0 b 0 0 0 0 0 s 0 0 0 0 0 0 0 0
0 b 0 0 0 0 0 0 0 0 0 0 0 0 0 0
0 0 0 0 0 0 0 0 0 0 0 0 0 0 0 0
0 0 0 0 0 0 0 s 0 0 0 m 0 0 0 0
0 0 0 0 0 0 s 0 s 0 0 0 0 0 0 0
0 0 0 0 0 s m m m s 0 0 0 s 0 0
0 0 0 0 s 0 m h m 0 s 0 0 0 0 0
0 0 0 0 0 s m m m s 0 0 0 0 0 0
0 0 0 0 0 0 s 0 s 0 0 0 0 0 0 0
0 0 0 m 0 0 0 s 0 0 0 n 0 0 0 0
0 0 0 0 0 0 0 0 0 0 0 0 0 0 0 0
0 0 0 0 0 0 0 0 0 0 0 0 0 0 0 0
0 0 0 0 0 0 0 0 0 0 0 0 0 0 0 0